{
  "Name": "The Maze",
  "Rows": 10,
  "Columns": 26,
  "BrickGrid": [
    [3, 3, 3, 3, 3, 3, 3, 3, 3, 3, 3, 0, 0, 0, 3, 3, 3, 3, 3, 3, 3, 3, 3, 3, 3, 3],
    [3, 0, 0, 0, 0, 0, 0, 0, 0, 0, 3, 0, 0, 0, 3, 0, 0, 0, 0, 0, 0, 0, 0, 0, 0, 3],
    [3, 0, 4, 4, 4, 0, 0, 0, 4, 4, 3, 0, 0, 0, 3, 4, 4, 0, 0, 0, 4, 4, 4, 0, 0, 3],
    [3, 0, 4, 0, 0, 0, 0, 0, 0, 4, 3, 0, 0, 0, 3, 4, 0, 0, 0, 0, 0, 0, 4, 0, 0, 3],
    [3, 0, 4, 0, 2, 2, 2, 2, 0, 4, 3, 0, 0, 0, 3, 4, 0, 2, 2, 2, 2, 0, 4, 0, 0, 3],
    [3, 0, 4, 0, 0, 0, 0, 0, 0, 4, 0, 0, 0, 0, 0, 4, 0, 0, 0, 0, 0, 0, 4, 0, 0, 3],
    [3, 0, 4, 4, 4, 0, 0, 0, 4, 4, 0, 0, 0, 0, 0, 4, 4, 0, 0, 0, 4, 4, 4, 0, 0, 3],
    [3, 0, 0, 0, 0, 0, 0, 0, 0, 0, 0, 0, 0, 0, 0, 0, 0, 0, 0, 0, 0, 0, 0, 0, 0, 3],
    [3, 5, 5, 5, 5, 5, 5, 5, 5, 5, 5, 5, 5, 5, 5, 5, 5, 5, 5, 5, 5, 5, 5, 5, 5, 3],
    [3, 3, 3, 3, 3, 3, 3, 3, 3, 3, 3, 3, 3, 3, 3, 3, 3, 3, 3, 3, 3, 3, 3, 3, 3, 3]
  ]
}
